1. 添加/删除元素

push(): 在数组的末尾添加一个或多个元素，并返回新的长度。

pop(): 删除数组的最后一个元素并返回那个元素。

shift(): 删除数组的第一个元素并返回那个元素，数组中的其他元素向前移动。

unshift(): 在数组的开头添加一个或多个元素，并返回新的长度。

splice(): 通过删除现有元素和/或添加新元素来更改一个数组的内容。

2. 迭代元素
forEach(): 对数组的每个元素执行一次给定的函数。

map(): 创建一个新数组，其结果是该数组中的每个元素是调用一次提供的函数后的返回值。

filter(): 创建一个新数组，包含通过所提供函数实现的测试的所有元素。

reduce(): 对数组中的每个元素执行一个由您提供的reducer函数（升序执行），将其结果汇总为单个返回值。

reduceRight(): 类似 reduce()，但从数组的末尾向前工作。

every(): 检测数组所有元素是否都符合指定条件（通过函数提供）
。
some(): 检测数组中的某些元素是否符合指定条件（通过函数提供）。

3. 搜索元素
indexOf(): 返回在数组中可以找到一个给定元素的第一个索引，如果不存在，则返回-1。

lastIndexOf(): 返回在数组中可以找到一个给定元素的最后一个索引，如果不存在，则返回-1。

find(): 返回数组中满足提供的测试函数的第一个元素的值，否则返回 undefined。

findIndex(): 返回数组中满足提供的测试函数的第一个元素的索引，否则返回-1。

4. 切片和连接
slice(): 返回一个新的数组对象，这一对象是一个由 begin 和 end 决定的原数组的浅拷贝（包括 begin，不包括end）
。
concat(): 用于合并两个或多个数组。此方法不会改变现有的数组，而是返回一个新数组。

5. 转换
join(): 把数组的所有元素放入一个字符串。元素通过指定的分隔符进行分隔。

toString(): 返回一个由所有数组元素组合而成的字符串。每个元素通过逗号分隔。

6. 排序
sort(): 对数组元素进行排序，并返回数组。默认排序顺序是在将元素转换为字符串，然后比较它们的 UTF-16 代码单元值序列时构建的。

reverse(): 颠倒数组中元素的顺序。